%%%%%%%%%%%%%%%%%%%%%%%%%%%%%%%%%%%%%%%%%%%%%%%%%%%%%%%                                                    
%                             %      %     %          %
%     %%%%%     %%%%%%       %%%     %     %          %
% %%%%%                      %%%     %     %          %
%     %         %%%%%        %%%     %     %          %
%     %         %%%           %            %%%%%%     %
%     %       %%%%%                                   %
%                                  %%%       %%%%     %
%          %%%%                    %%%       %        %
%             %    %%%%%           %%%                %
%%%%%%%       %    %               %%%     %%%%%%%%%%%%
%                  %                           %      %
%       %%%%       %       %%%                 %      %
%        %%        %    %%%       %            %      %
%        %%        %%%%%        %%%%%    %     %      %
%                                 %      %%           %
%                                        %%%          %
%    %%%%%%%%%                %     %    %%%%%        %
%   %        %       %        %%%%%%%                 %
%  %         %      %%%          %           %%%%%%%%%%
% %                %%%%%         %           %        %
%%                               %                    %
%%%%%%%%%%%%%%%%%%%%%%%%%%%%%%%%%%%%%%%%%%%%%%%%%%%%%%%