$$$$$$$$$$$$$$$$$$$$$$$$$$$$$$$$$$$$$$$$$$$$$$$$$$$$$$$
$                    $$           $              $    $
$                    $$    $$$    $    $         $    $
$   $        $$$$$$$$$$    $$$    $    $         $    $
$   $$               $$           $$$$$$$$$$          $
$   $$$              $$        $$$$                   $
$   $$$$                                              $
$   $$$                                               $
$   $$           $       $$$$$$            $$$$$$     $
$   $            $          $$$$$$$     $$$$$$$       $
$$$$$$$$$$       $              $$$$$$$$$$$           $
$         $      $          $$$$$$$     $$$$$$$       $
$     $$$$$              $$$$$$            $$$$$$     $
$                                                     $
$  $$   $$   $$      $$$$                             $
$ $  $ $  $ $  $     $                     $$$$$      $
$$    $    $    $    $        $$$$$$                  $
$                    $$$$      $$$$                   $
$                              $$$$       $$$$$$$$    $
$   $    $$    $              $$$$$$      $      $    $
$  $     $$     $                         $           $
$ $      $$      $                        $           $
$$$$$$$$$$$$$$$$$$$$$$$$$$$$$$$$$$$$$$$$$$$$$$$$$$$$$$$